11111011111111111011111111101111111011111111111010
10001010000010001010000000001000101000100000001010
11101011101110111011111110111011101110101111101110
00100000101000001000000010100010000010101010000010
11101111101111101111101110101110111011101010111110
10001000001000100000101000101010101000000010100000
10111011101110111010101111101010101110111110101110
10100010100000001010100000001000100010100000100010
11101110111111111010111111101110111010101111101110
10001010000000000010000000100010001010101000001000
10111010111110101111111110111011111010111010111110
10100000100010101000000010001000000010100010100010
10111111101010111011111011101111111010101111101110
10000000001010000010001000100000001010100000001000
11101111111011111110111011101111111110111111101110
00101000000010000000100010001000000000000000101010
11101011111011101111101110111111111011101110101010
10001010001000101000001000100000100010100010100010
11111010111011101111101111101110101110111010111110
00000010100010000000100010001010001000001010000010
11101110111011111010111011101011101011101011111110
10101000001000001010001000001000101000101010000000
10111010111010111111101110111010101110111011111010
10000010100010100000100010100010101010100000001010
10111110111011101110101110101011101010111110101010
10100010001000001010001010101010001010000010101010
10111011101111111011101010111011101010101110111010
10000010000000000000101000000000101010101000001010
11111011111011101011101121111110101010101111101110
10001000101010101010001000000010100010100000100010
11101110101110101011101110111110111110111011101110
10000010100000101000100000101000000000100010000000
10111110111110101110111011101011111111101110111110
10100000100010100010001010001010001000101000100010
10111010101110111110111011101011101110101011101110
10001010101000000000100010101000100010001000101000
10101011101110111110101110101011101011111011101010
10101000100010100010100000101010001000000010001010
11101110111011111011111111101010111111111111101110
10000010001000000000100000001010000010000010100010
10111011101110111110101110111011111010111010111010
10101000100010100010101010100000001010101000001010
10101011101010111010101010101111101010101111111010
10101010001010001010001010101010101000100000000010
10101110111111101011101010101010101111101011111130
10100000000000001000101010001010100000001010000000
10101111101111101010101011111010101110111110111110
10101000101000101010101000000010001010100000001010
10111110111110111110111111111011111011111111111010
00000000000000000000000000000000000000000000000000
